admin	"admin"	"admin",
blog	"blog"	"blog",
dev	"dev"	"dev",
ftp	"ftp"	"ftp",
mail	"mail"	"mail",
pop	"pop"	"pop",
pop3	"pop3"	"pop3",
imap	"imap"	"imap",
smtp	"smtp"	"smtp",
stage	"stage"	"stage",
stats	"stats"	"stats",
status	"status"	"status",
www	"www"	"www",
beta	"beta"	"beta",
about	"about"	"about",
access	"access"	"access",
account	"account"	"account",
accounts	"accounts"	"accounts",
add	"add"	"add",
address	"address"	"address",
adm	"adm"	"adm",
admin	"admin"	"admin",
administration	"administration"	"administration",
adult	"adult"	"adult",
advertising	"advertising"	"advertising",
affiliate	"affiliate"	"affiliate",
affiliates	"affiliates"	"affiliates",
ajax	"ajax"	"ajax",
analytics	"analytics"	"analytics",
android	"android"	"android",
anon	"anon"	"anon",
anonymous	"anonymous"	"anonymous",
api	"api"	"api",
app	"app"	"app",
apps	"apps"	"apps",
archive	"archive"	"archive",
atom	"atom"	"atom",
auth	"auth"	"auth",
authentication	"authentication"	"authentication",
avatar	"avatar"	"avatar",
backup	"backup"	"backup",
banner	"banner"	"banner",
banners	"banners"	"banners",
bin	"bin"	"bin",
billing	"billing"	"billing",
blog	"blog"	"blog",
blogs	"blogs"	"blogs",
board	"board"	"board",
bot	"bot"	"bot",
bots	"bots"	"bots",
business	"business"	"business",
chat	"chat"	"chat",
cache	"cache"	"cache",
cadastro	"cadastro"	"cadastro",
calendar	"calendar"	"calendar",
campaign	"campaign"	"campaign",
careers	"careers"	"careers",
cgi	"cgi"	"cgi",
client	"client"	"client",
cliente	"cliente"	"cliente",
code	"code"	"code",
comercial	"comercial"	"comercial",
compare	"compare"	"compare",
config	"config"	"config",
connect	"connect"	"connect",
contact	"contact"	"contact",
contest	"contest"	"contest",
create	"create"	"create",
code	"code"	"code",
compras	"compras"	"compras",
css	"css"	"css",
dashboard	"dashboard"	"dashboard",
data	"data"	"data",
db	"db"	"db",
design	"design"	"design",
delete	"delete"	"delete",
demo	"demo"	"demo",
design	"design"	"design",
designer	"designer"	"designer",
dev	"dev"	"dev",
devel	"devel"	"devel",
dir	"dir"	"dir",
directory	"directory"	"directory",
doc	"doc"	"doc",
docs	"docs"	"docs",
domain	"domain"	"domain",
download	"download"	"download",
downloads	"downloads"	"downloads",
edit	"edit"	"edit",
editor	"editor"	"editor",
email	"email"	"email",
ecommerce	"ecommerce"	"ecommerce",
forum	"forum"	"forum",
forums	"forums"	"forums",
faq	"faq"	"faq",
favorite	"favorite"	"favorite",
feed	"feed"	"feed",
feedback	"feedback"	"feedback",
flog	"flog"	"flog",
follow	"follow"	"follow",
file	"file"	"file",
files	"files"	"files",
free	"free"	"free",
ftp	"ftp"	"ftp",
gadget	"gadget"	"gadget",
gadgets	"gadgets"	"gadgets",
games	"games"	"games",
guest	"guest"	"guest",
group	"group"	"group",
groups	"groups"	"groups",
help	"help"	"help",
home	"home"	"home",
homepage	"homepage"	"homepage",
host	"host"	"host",
hosting	"hosting"	"hosting",
hostname	"hostname"	"hostname",
html	"html"	"html",
http	"http"	"http",
httpd	"httpd"	"httpd",
https	"https"	"https",
hpg	"hpg"	"hpg",
info	"info"	"info",
information	"information"	"information",
image	"image"	"image",
img	"img"	"img",
images	"images"	"images",
imap	"imap"	"imap",
index	"index"	"index",
invite	"invite"	"invite",
intranet	"intranet"	"intranet",
indice	"indice"	"indice",
ipad	"ipad"	"ipad",
iphone	"iphone"	"iphone",
irc	"irc"	"irc",
java	"java"	"java",
javascript	"javascript"	"javascript",
job	"job"	"job",
jobs	"jobs"	"jobs",
js	"js"	"js",
knowledgebase	"knowledgebase"	"knowledgebase",
log	"log"	"log",
login	"login"	"login",
logs	"logs"	"logs",
logout	"logout"	"logout",
list	"list"	"list",
lists	"lists"	"lists",
mail	"mail"	"mail",
mail1	"mail1"	"mail1",
mail2	"mail2"	"mail2",
mail3	"mail3"	"mail3",
mail4	"mail4"	"mail4",
mail5	"mail5"	"mail5",
mailer	"mailer"	"mailer",
mailing	"mailing"	"mailing",
mx	"mx"	"mx",
manager	"manager"	"manager",
marketing	"marketing"	"marketing",
master	"master"	"master",
me	"me"	"me",
media	"media"	"media",
message	"message"	"message",
microblog	"microblog"	"microblog",
microblogs	"microblogs"	"microblogs",
mine	"mine"	"mine",
mp3	"mp3"	"mp3",
msg	"msg"	"msg",
msn	"msn"	"msn",
mysql	"mysql"	"mysql",
messenger	"messenger"	"messenger",
mob	"mob"	"mob",
mobile	"mobile"	"mobile",
movie	"movie"	"movie",
movies	"movies"	"movies",
music	"music"	"music",
musicas	"musicas"	"musicas",
my	"my"	"my",
name	"name"	"name",
named	"named"	"named",
net	"net"	"net",
network	"network"	"network",
new	"new"	"new",
news	"news"	"news",
newsletter	"newsletter"	"newsletter",
nick	"nick"	"nick",
nickname	"nickname"	"nickname",
notes	"notes"	"notes",
noticias	"noticias"	"noticias",
ns	"ns"	"ns",
ns1	"ns1"	"ns1",
ns2	"ns2"	"ns2",
ns3	"ns3"	"ns3",
ns4	"ns4"	"ns4",
ns5	"ns5"	"ns5",
ns6	"ns6"	"ns6",
ns7	"ns7"	"ns7",
ns8	"ns8"	"ns8",
ns9	"ns9"	"ns9",
ns10	"ns10"	"ns10",
old	"old"	"old",
online	"online"	"online",
operator	"operator"	"operator",
order	"order"	"order",
orders	"orders"	"orders",
page	"page"	"page",
pager	"pager"	"pager",
pages	"pages"	"pages",
panel	"panel"	"panel",
password	"password"	"password",
perl	"perl"	"perl",
pic	"pic"	"pic",
pics	"pics"	"pics",
photo	"photo"	"photo",
photos	"photos"	"photos",
photoalbum	"photoalbum"	"photoalbum",
php	"php"	"php",
plugin	"plugin"	"plugin",
plugins	"plugins"	"plugins",
pop	"pop"	"pop",
pop3	"pop3"	"pop3",
post	"post"	"post",
postmaster	"postmaster"	"postmaster",
postfix	"postfix"	"postfix",
posts	"posts"	"posts",
profile	"profile"	"profile",
project	"project"	"project",
projects	"projects"	"projects",
promo	"promo"	"promo",
pub	"pub"	"pub",
public	"public"	"public",
python	"python"	"python",
random	"random"	"random",
register	"register"	"register",
registration	"registration"	"registration",
root	"root"	"root",
ruby	"ruby"	"ruby",
rss	"rss"	"rss",
sale	"sale"	"sale",
sales	"sales"	"sales",
sample	"sample"	"sample",
samples	"samples"	"samples",
script	"script"	"script",
scripts	"scripts"	"scripts",
secure	"secure"	"secure",
send	"send"	"send",
service	"service"	"service",
shop	"shop"	"shop",
sql	"sql"	"sql",
signup	"signup"	"signup",
signin	"signin"	"signin",
search	"search"	"search",
security	"security"	"security",
settings	"settings"	"settings",
setting	"setting"	"setting",
setup	"setup"	"setup",
site	"site"	"site",
sites	"sites"	"sites",
sitemap	"sitemap"	"sitemap",
smtp	"smtp"	"smtp",
soporte	"soporte"	"soporte",
ssh	"ssh"	"ssh",
stage	"stage"	"stage",
staging	"staging"	"staging",
start	"start"	"start",
subscribe	"subscribe"	"subscribe",
subdomain	"subdomain"	"subdomain",
suporte	"suporte"	"suporte",
support	"support"	"support",
stat	"stat"	"stat",
static	"static"	"static",
stats	"stats"	"stats",
status	"status"	"status",
store	"store"	"store",
stores	"stores"	"stores",
system	"system"	"system",
tablet	"tablet"	"tablet",
tablets	"tablets"	"tablets",
tech	"tech"	"tech",
telnet	"telnet"	"telnet",
test	"test"	"test",
test1	"test1"	"test1",
test2	"test2"	"test2",
test3	"test3"	"test3",
teste	"teste"	"teste",
tests	"tests"	"tests",
theme	"theme"	"theme",
themes	"themes"	"themes",
tmp	"tmp"	"tmp",
todo	"todo"	"todo",
task	"task"	"task",
tasks	"tasks"	"tasks",
tools	"tools"	"tools",
tv	"tv"	"tv",
talk	"talk"	"talk",
update	"update"	"update",
upload	"upload"	"upload",
url	"url"	"url",
user	"user"	"user",
username	"username"	"username",
usuario	"usuario"	"usuario",
usage	"usage"	"usage",
vendas	"vendas"	"vendas",
video	"video"	"video",
videos	"videos"	"videos",
visitor	"visitor"	"visitor",
win	"win"	"win",
ww	"ww"	"ww",
www	"www"	"www",
www1	"www1"	"www1",
www2	"www2"	"www2",
www3	"www3"	"www3",
www4	"www4"	"www4",
www5	"www5"	"www5",
www6	"www6"	"www6",
www7	"www7"	"www7",
wwww	"wwww"	"wwww",
wws	"wws"	"wws",
wwws	"wwws"	"wwws",
web	"web"	"web",
webmail	"webmail"	"webmail",
website	"website"	"website",
websites	"websites"	"websites",
webmaster	"webmaster"	"webmaster",
workshop	"workshop"	"workshop",
xxx	"xxx"	"xxx",
xpg	"xpg"	"xpg",
you	"you"	"you",
yourname	"yourname"	"yourname",
yourusername	"yourusername"	"yourusername",
yoursite	"yoursite"	"yoursite",
yourdomain	"yourdomain"	"yourdomain",